width 80
level
























#   # ##### #   #     #   # ##### #   #
#   # #   # #   #     # # #   #   ##  #
##### #   # #   #     # # #   #   # # # 
  #   #   # #   #     # # #   #   #  ##
  #   ##### #####     ##### ##### #   #























##################################################################
##################################################################
##################################################################





          F                                                     





                                                                F





                                  #######
                                  #######
                                  #######
                                  #######













              ~                                                   ~




##################################            ##################################
##################################         ?  ##################################
##################################            ##################################






















                                  #############
                                  #############
                                  #############               ?
                                  #############
                                  #############






                                                              F




                 F



#################################             ##################################
#################################             ##################################
#################################             ##################################













                                  #############
                                  #############
                  ?               #############               ?
                                  #############
                                  #############








#################################             ##################################
#################################             ##################################
#################################             ##################################










                           ?










                                        ########################################
                                        ########################################
                                        ########################################











########################################
########################################
########################################


